선수명,ID,팀명,경기,도루시도,도루허용,도루실패,도루성공률,주루사,견제사
이대형,73153,LG,130,87,66,21,75.9,0,0
김주찬,70410,롯데,118,84,65,19,77.4,0,0
장기영,71347,넥센,119,55,41,14,74.5,0,0
오재원,77248,두산,123,45,35,10,77.8,0,0
정근우,75808,SK,128,46,33,13,71.7,0,0
조동찬,72466,삼성,95,38,33,5,86.8,0,0
이종욱,73339,두산,114,43,30,13,69.8,0,0
김상수,79402,삼성,101,36,30,6,83.3,0,0
이영욱,78467,삼성,120,38,30,8,78.9,0,0
김민우,72303,넥센,128,34,28,6,82.4,0,0
이용규,74163,KIA,129,37,25,12,67.6,0,0
전현태,75706,한화,100,33,25,8,75.8,0,0
김선빈,78603,KIA,115,30,23,7,76.7,0,0
김강민,71837,SK,115,32,23,9,71.9,0,0
김일경,97300,넥센,104,27,21,6,77.8,0,0
신명철,71504,삼성,125,29,20,9,69.0,0,0
박용택,72133,LG,107,23,19,4,82.6,0,0
안치홍,79608,KIA,133,23,18,5,78.3,0,0
황재균,76313,롯데,94,25,18,7,72.0,0,0
박정권,74846,SK,124,22,17,5,77.3,0,0
신종길,72559,KIA,58,18,16,2,88.9,0,0
전준우,78513,롯데,114,23,16,7,69.6,0,0
김원섭,71207,KIA,111,21,15,6,71.4,0,0
조동화,71848,SK,115,17,15,2,88.2,0,0
나주환,73209,SK,100,20,14,6,70.0,0,0
이택근,73342,LG,91,20,14,6,70.0,0,0
강동우,98420,한화,98,20,14,6,70.0,0,0
정원석,70240,한화,118,23,14,9,60.9,0,0
정수빈,79231,두산,76,16,13,3,81.3,0,0
오지환,79109,LG,125,15,13,2,86.7,0,0
최정,75847,SK,123,16,12,4,75.0,0,0
클락,78725,넥센,92,19,12,7,63.2,0,0
고영민,72214,두산,100,14,11,3,78.6,0,0
민병헌,76249,두산,64,15,11,4,73.3,0,0
박경수,73113,LG,80,12,10,2,83.3,0,0
이진영,99810,LG,104,14,10,4,71.4,0,0
추승우,72139,한화,111,16,10,6,62.5,0,0
박재상,71857,SK,97,15,9,6,60.0,0,0
김연훈,77609,SK,73,12,8,4,66.7,0,0
조성환,99543,롯데,111,10,8,2,80.0,0,0
강봉규,70224,삼성,89,8,8,0,100,0,0
박용근,77104,LG,53,10,8,2,80.0,0,0
김경언,71610,한화,50,12,8,4,66.7,0,0
김재현,94107,SK,111,12,7,5,58.3,0,0
임훈,74823,SK,76,12,7,5,58.3,0,0
최윤석,60805,SK,47,8,7,1,87.5,0,0
임재철,99507,두산,96,10,7,3,70.0,0,0
강명구,73409,삼성,55,10,7,3,70.0,0,0
김태완,76746,한화,116,13,7,6,53.8,0,0
오선진,78756,한화,108,9,7,2,77.8,0,0
이성열,73136,두산,129,9,6,3,66.7,0,0
손아섭,77532,롯데,121,8,6,2,75.0,0,0
조영훈,75441,삼성,67,8,6,2,75.0,0,0
신경현,98742,한화,119,11,6,5,54.5,0,0
모창민,78813,SK,65,8,5,3,62.5,0,0
김재호,74206,두산,83,6,5,1,83.3,0,0
박종윤,71562,롯데,110,9,5,4,55.6,0,0
박한이,71432,삼성,128,9,5,4,55.6,0,0
송지만,96761,넥센,127,7,5,2,71.4,0,0
이숭용,94310,넥센,124,7,5,2,71.4,0,0
박병호,75125,LG,78,6,5,1,83.3,0,0
이병규,76100,LG,103,8,5,3,62.5,0,0
이학준,74148,LG,13,5,5,0,100,0,0
이상훈,60724,한화,34,6,5,1,83.3,0,0
최진행,74729,한화,129,9,5,4,55.6,0,0
최희섭,77623,KIA,126,7,4,3,57.1,0,0
김현수,76290,두산,132,12,4,8,33.3,0,0
양의지,76232,두산,127,5,4,1,80.0,0,0
임익준,77464,삼성,64,7,4,3,57.1,0,0
최형우,72443,삼성,121,4,4,0,100,0,0
송광민,76753,한화,77,8,4,4,50.0,0,0
김상현,70646,KIA,79,4,3,1,75.0,0,0
나지완,78629,KIA,109,5,3,2,60.0,0,0
박기남,74103,KIA,76,6,3,3,50.0,0,0
가르시아,78595,롯데,118,3,3,0,100,0,0
황성용,76562,롯데,44,3,3,0,100,0,0
박석민,74465,삼성,112,5,3,2,60.0,0,0
이병규,97109,LG,117,7,3,4,42.9,0,0
정성훈,99606,LG,111,4,3,1,75.0,0,0
이양기,73725,한화,27,3,3,0,100,0,0
정현석,78745,한화,114,6,3,3,50.0,0,0
정희상,75762,한화,29,3,3,0,100,0,0
이종범,93607,KIA,97,4,2,2,50.0,0,0
최훈락,75608,KIA,19,5,2,3,40.0,0,0
권용관,95158,SK,61,4,2,2,50.0,0,0
안치용,72161,SK,30,3,2,1,66.7,0,0
강민호,74540,롯데,117,9,2,7,22.2,0,0
문규현,72546,롯데,80,3,2,1,66.7,0,0
박기혁,70553,롯데,48,2,2,0,100,0,0
이승화,71565,롯데,92,3,2,1,66.7,0,0
홍성흔,99222,롯데,111,4,2,2,50.0,0,0
이정식,74402,삼성,50,2,2,0,100,0,0
허승민,78458,삼성,14,2,2,0,100,0,0
강병식,72325,넥센,107,4,2,2,50.0,0,0
강병우,75143,넥센,11,4,2,2,50.0,0,0
강정호,76325,넥센,133,4,2,2,50.0,0,0
유선정,76322,넥센,53,3,2,1,66.7,0,0
유한준,74339,넥센,131,4,2,2,50.0,0,0
조인성,98144,LG,133,2,2,0,100,0,0
이대수,72860,한화,125,6,2,4,33.3,0,0
이희근,78739,한화,82,4,2,2,50.0,0,0
한윤섭,78762,한화,30,2,2,0,100,0,0
김다원,78765,KIA,45,1,1,0,100,0,0
김상훈,70612,KIA,107,3,1,2,33.3,0,0
차일목,73602,KIA,91,2,1,1,50.0,0,0
박경완,92809,SK,129,2,1,1,50.0,0,0
박재홍,96362,SK,82,3,1,2,33.3,0,0
이호준,94629,SK,85,1,1,0,100,0,0
이두환,77242,두산,13,1,1,0,100,0,0
이원석,75566,두산,104,5,1,4,20.0,0,0
박준서,71815,롯데,22,1,1,0,100,0,0
박진만,96307,삼성,46,3,1,2,33.3,0,0
배영섭,79465,삼성,11,1,1,0,100,0,0
오정복,79453,삼성,100,5,1,4,20.0,0,0
현재윤,72427,삼성,53,2,1,1,50.0,0,0
김민성,77564,넥센,80,1,1,0,100,0,0
정수성,97350,넥센,8,1,1,0,100,0,0
손인호,98538,LG,42,1,1,0,100,0,0
윤상균,78892,LG,46,1,1,0,100,0,0
정주현,79150,LG,8,2,1,1,50.0,0,0
전근표,70364,한화,40,2,1,1,50.0,0,0
김건한,71851,KIA,3,0,0,0,-,0,0
김형철,73827,KIA,9,0,0,0,-,0,0
박경태,76653,KIA,6,0,0,0,-,0,0
박성호,79760,KIA,2,0,0,0,-,0,0
손영민,76639,KIA,2,0,0,0,-,0,0
심동섭,60636,KIA,1,0,0,0,-,0,0
안영명,73738,KIA,2,0,0,0,-,0,0
유동훈,99639,KIA,3,0,0,0,-,0,0
윤석민,75620,KIA,1,0,0,0,-,0,0
윤효섭,79653,KIA,1,0,0,0,-,0,0
이성우,71184,KIA,10,0,0,0,-,0,0
이영수,74650,KIA,42,0,0,0,-,0,0
이종환,60667,KIA,47,0,0,0,-,0,0
이현곤,72606,KIA,108,2,0,2,0.0,0,0
임한용,60655,KIA,2,0,0,0,-,0,0
장태성,79642,KIA,3,0,0,0,-,0,0
조태수,73657,KIA,4,0,0,0,-,0,0
채종범,70833,KIA,29,1,0,1,0.0,0,0
최용규,78666,KIA,22,0,0,0,-,0,0
홍세완,70626,KIA,10,0,0,0,-,0,0
홍재호,60605,KIA,24,0,0,0,-,0,0
가득염,92501,SK,1,0,0,0,-,0,0
고효준,72523,SK,2,0,0,0,-,0,0
김광현,77829,SK,1,0,0,0,-,0,0
박상현,79866,SK,1,0,0,0,-,0,0
박정환,70408,SK,44,2,0,2,0.0,0,0
박희수,76858,SK,1,0,0,0,-,0,0
송은범,73801,SK,1,0,0,0,-,0,0
안경현,92207,SK,8,0,0,0,-,0,0
이명기,76849,SK,4,0,0,0,-,0,0
이승호,70820,SK,2,0,0,0,-,0,0
이재원,76812,SK,54,0,0,0,-,0,0
전병두,73228,SK,1,0,0,0,-,0,0
정상호,71842,SK,35,0,0,0,-,0,0
정우람,74857,SK,1,0,0,0,-,0,0
최경철,73824,SK,1,0,0,0,-,0,0
최동수,94132,SK,56,1,0,1,0.0,0,0
하지호,79804,SK,9,0,0,0,-,0,0
고창성,78248,두산,3,0,0,0,-,0,0
김동길,60296,두산,8,0,0,0,-,0,0
김동주,98218,두산,110,1,0,1,0.0,0,0
김승회,73248,두산,2,0,0,0,-,0,0
노경은,73211,두산,1,0,0,0,-,0,0
박정배,75250,두산,2,0,0,0,-,0,0
성영훈,79222,두산,1,0,0,0,-,0,0
손시헌,73213,두산,128,2,0,2,0.0,0,0
오현근,78850,두산,3,0,0,0,-,0,0
오현택,79293,두산,1,0,0,0,-,0,0
용덕한,74223,두산,43,0,0,0,-,0,0
유재웅,72220,두산,53,0,0,0,-,0,0
유희관,79229,두산,1,0,0,0,-,0,0
이용찬,77211,두산,3,0,0,0,-,0,0
이재학,60263,두산,1,0,0,0,-,0,0
임태훈,77251,두산,1,0,0,0,-,0,0
정재훈,73241,두산,4,0,0,0,-,0,0
조규수,70755,두산,1,0,0,0,-,0,0
조승수,79235,두산,2,0,0,0,-,0,0
최승환,70122,두산,42,0,0,0,-,0,0
최준석,71552,두산,127,5,0,5,0.0,0,0
홍상삼,78247,두산,3,0,0,0,-,0,0
강영식,70615,롯데,1,0,0,0,-,0,0
김사율,99563,롯데,2,0,0,0,-,0,0
박정준,73543,롯데,2,0,0,0,-,0,0
배장호,76540,롯데,1,0,0,0,-,0,0
변용선,60526,롯데,3,0,0,0,-,0,0
양종민,79530,롯데,7,0,0,0,-,0,0
이대호,71564,롯데,127,2,0,2,0.0,0,0
이인구,73563,롯데,5,0,0,0,-,0,0
이정민,72551,롯데,1,0,0,0,-,0,0
이정훈,97541,롯데,4,0,0,0,-,0,0
장성우,78548,롯데,61,1,0,1,0.0,0,0
정보명,73513,롯데,30,1,0,1,0.0,0,0
정훈,60523,롯데,29,0,0,0,-,0,0
허준혁,74556,롯데,3,0,0,0,-,0,0
권오준,99445,삼성,1,0,0,0,-,0,0
권혁,72447,삼성,2,0,0,0,-,0,0
김효남,76454,삼성,1,0,0,0,-,0,0
손주인,72456,삼성,27,1,0,1,0.0,0,0
양준혁,93410,삼성,64,1,0,1,0.0,0,0
윤성환,74454,삼성,1,0,0,0,-,0,0
장원삼,76355,삼성,1,0,0,0,-,0,0
정현욱,96462,삼성,4,0,0,0,-,0,0
정형식,79459,삼성,7,1,0,1,0.0,0,0
진갑용,97202,삼성,100,0,0,0,-,0,0
채상병,72742,삼성,17,0,0,0,-,0,0
채태인,77463,삼성,102,3,0,3,0.0,0,0
강귀태,72312,넥센,97,2,0,2,0.0,0,0
고원준,79349,넥센,1,0,0,0,-,0,0
권도영,73363,넥센,37,1,0,1,0.0,0,0
김성현,78353,넥센,1,0,0,0,-,0,0
김정훈,60339,넥센,1,0,0,0,-,0,0
김지수,79300,넥센,8,0,0,0,-,0,0
박동원,79365,넥센,7,0,0,0,-,0,0
박성훈,75464,넥센,1,0,0,0,-,0,0
박준수,70349,넥센,1,0,0,0,-,0,0
배힘찬,72321,넥센,1,0,0,0,-,0,0
손승락,75321,넥센,3,0,0,0,-,0,0
송신영,99314,넥센,3,0,0,0,-,0,0
오윤,70312,넥센,37,1,0,1,0.0,0,0
오재영,74359,넥센,2,0,0,0,-,0,0
오재일,75334,넥센,39,0,0,0,-,0,0
이보근,75342,넥센,1,0,0,0,-,0,0
이창섭,60304,넥센,8,0,0,0,-,0,0
장영석,79334,넥센,64,0,0,0,-,0,0
장종덕,60340,넥센,2,0,0,0,-,0,0
조재호,72313,넥센,46,0,0,0,-,0,0
조중근,71835,넥센,21,0,0,0,-,0,0
허준,75344,넥센,73,1,0,1,0.0,0,0
김선규,75852,LG,2,0,0,0,-,0,0
김준호,77156,LG,21,0,0,0,-,0,0
김태군,78122,LG,50,0,0,0,-,0,0
김태완,74158,LG,72,2,0,2,0.0,0,0
류택현,94228,LG,1,0,0,0,-,0,0
문선재,79113,LG,7,0,0,0,-,0,0
박동욱,74363,LG,1,0,0,0,-,0,0
박현준,79817,LG,1,0,0,0,-,0,0
백창수,60100,LG,15,0,0,0,-,0,0
서동욱,73606,LG,11,0,0,0,-,0,0
서성종,72822,LG,4,0,0,0,-,0,0
오카모토,60156,LG,1,0,0,0,-,0,0
윤진호,79198,LG,17,0,0,0,-,0,0
이상열,96720,LG,1,0,0,0,-,0,0
정재복,73166,LG,1,0,0,0,-,0,0
황선일,76404,LG,4,0,0,0,-,0,0
김강,77733,한화,14,0,0,0,-,0,0
김강석,79704,한화,3,0,0,0,-,0,0
김동영,75739,한화,3,0,0,0,-,0,0
김재우,60759,한화,5,0,0,0,-,0,0
김회성,79705,한화,11,0,0,0,-,0,0
데폴라,60729,한화,4,0,0,0,-,0,0
류현진,76715,한화,2,0,0,0,-,0,0
박노민,74756,한화,21,0,0,0,-,0,0
박정진,99737,한화,3,0,0,0,-,0,0
손지환,97103,한화,25,2,0,2,0.0,0,0
송창식,74731,한화,1,0,0,0,-,0,0
신해수,76763,한화,1,0,0,0,-,0,0
안승민,60713,한화,2,0,0,0,-,0,0
양훈,75750,한화,3,0,0,0,-,0,0
윤근영,75730,한화,2,0,0,0,-,0,0
이도형,93225,한화,27,0,0,0,-,0,0
이동현,74620,한화,3,0,0,0,-,0,0
이성호,78768,한화,5,0,0,0,-,0,0
이여상,76435,한화,14,0,0,0,-,0,0
이영우,96734,한화,12,1,0,1,0.0,0,0
장성호,96610,한화,74,2,0,2,0.0,0,0
정재원,74748,한화,2,0,0,0,-,0,0
허유강,79746,한화,1,0,0,0,-,0,0
황재규,79758,한화,3,0,0,0,-,0,0
