선수명,ID,팀명,경기,도루시도,도루허용,도루실패,도루성공률,주루사,견제사
이대형,73153,LG,125,73,53,20,72.6,0,0
이종욱,73339,두산,123,61,47,14,77.0,0,0
고영민,72214,두산,126,46,36,10,78.3,0,0
민병헌,76249,두산,119,39,30,9,76.9,0,0
조동화,71848,SK,121,31,25,6,80.6,0,0
정근우,75808,SK,111,34,24,10,70.6,0,0
김주찬,70410,롯데,113,30,22,8,73.3,0,0
박재상,71857,SK,123,28,21,7,75.0,0,0
양준혁,93410,삼성,123,28,20,8,71.4,0,0
박용택,72133,LG,126,22,20,2,90.9,0,0
신명철,71504,삼성,126,28,19,9,67.9,0,0
김강민,71837,SK,124,29,19,10,65.5,0,0
김재걸,95409,삼성,116,24,17,7,70.8,0,0
이용규,74163,KIA,118,28,17,11,60.7,0,0
강명구,73409,삼성,68,16,13,3,81.3,0,0
김종국,96616,KIA,93,16,13,3,81.3,0,0
전준호,91511,현대,121,19,11,8,57.9,0,0
김동주,98218,두산,119,13,11,2,84.6,0,0
이승화,71565,롯데,75,19,11,8,57.9,0,0
권용관,95158,LG,121,15,11,4,73.3,0,0
박한이,71432,삼성,123,13,10,3,76.9,0,0
고동진,74745,한화,124,14,10,4,71.4,0,0
송지만,96761,현대,120,14,10,4,71.4,0,0
박재홍,96362,SK,115,17,10,7,58.8,0,0
정수근,95208,롯데,105,15,10,5,66.7,0,0
박경수,73113,LG,115,13,10,3,76.9,0,0
김일경,97300,현대,117,12,9,3,75.0,0,0
김원섭,71207,KIA,114,18,9,9,50.0,0,0
장성호,96610,KIA,116,13,9,4,69.2,0,0
전상렬,91465,두산,75,14,9,5,64.3,0,0
최정,75847,SK,122,15,8,7,53.3,0,0
김민재,91523,한화,118,10,7,3,70.0,0,0
이성열,73136,LG,75,8,7,1,87.5,0,0
심정수,94204,삼성,124,6,6,0,100,0,0
조원우,94836,한화,114,7,6,1,85.7,0,0
한상훈,73703,한화,118,11,6,5,54.5,0,0
이택근,73342,현대,116,7,6,1,85.7,0,0
박경완,92809,SK,119,9,6,3,66.7,0,0
이진영,99810,SK,80,6,6,0,100,0,0
김상현,70646,LG,121,6,6,0,100,0,0
박진만,96307,삼성,100,8,5,3,62.5,0,0
김현수,76290,두산,99,7,5,2,71.4,0,0
윤재국,98808,두산,74,9,5,4,55.6,0,0
이대수,72860,두산,109,8,5,3,62.5,0,0
정원석,70240,두산,78,6,5,1,83.3,0,0
박기혁,70553,롯데,108,9,5,4,55.6,0,0
정보명,73513,롯데,119,6,5,1,83.3,0,0
오태근,72169,LG,68,10,5,5,50.0,0,0
이종열,91015,LG,121,8,5,3,62.5,0,0
강봉규,70224,삼성,83,6,4,2,66.7,0,0
신경현,98742,한화,107,4,4,0,100,0,0
이영우,96734,한화,97,6,4,2,66.7,0,0
이현곤,72606,KIA,126,6,4,2,66.7,0,0
김재현,94107,SK,84,8,4,4,50.0,0,0
박용근,77104,LG,67,6,4,2,66.7,0,0
발데스,77157,LG,116,5,4,1,80.0,0,0
조동찬,72466,삼성,38,4,3,1,75.0,0,0
심광호,96722,한화,76,4,3,1,75.0,0,0
브룸바,73324,현대,126,5,3,2,60.0,0,0
김상훈,70612,KIA,109,3,3,0,100,0,0
송산,75612,KIA,76,6,3,3,50.0,0,0
이종범,93607,KIA,84,5,3,2,60.0,0,0
최희섭,77623,KIA,52,4,3,1,75.0,0,0
오재원,77248,두산,49,5,3,2,60.0,0,0
나주환,73209,SK,117,7,3,4,42.9,0,0
이호준,94629,SK,101,9,3,6,33.3,0,0
정경배,96441,SK,116,6,3,3,50.0,0,0
김창희,97644,삼성,100,6,2,4,33.3,0,0
김태균,71752,한화,118,3,2,1,66.7,0,0
이범호,70756,한화,126,2,2,0,100,0,0
김동수,90419,현대,111,6,2,4,33.3,0,0
유한준,74339,현대,112,2,2,0,100,0,0
이숭용,94310,현대,95,3,2,1,66.7,0,0
황재균,76313,현대,63,4,2,2,50.0,0,0
김연훈,77609,KIA,52,3,2,1,66.7,0,0
채상병,72742,두산,91,4,2,2,50.0,0,0
박정권,74846,SK,100,3,2,1,66.7,0,0
이원석,75566,롯데,121,7,2,5,28.6,0,0
이인구,73563,롯데,65,4,2,2,50.0,0,0
최만호,97351,롯데,41,3,2,1,66.7,0,0
정의윤,75151,LG,88,4,2,2,50.0,0,0
박정환,70408,삼성,46,1,1,0,100,0,0
조영훈,75441,삼성,66,1,1,0,100,0,0
김동영,75739,한화,16,2,1,1,50.0,0,0
김수연,96777,한화,31,2,1,1,50.0,0,0
정희상,75762,한화,41,1,1,0,100,0,0
크루즈,77725,한화,121,1,1,0,100,0,0
서한규,98504,현대,48,2,1,1,50.0,0,0
정성훈,99606,현대,122,3,1,2,33.3,0,0
정수성,97350,현대,23,3,1,2,33.3,0,0
차화준,75307,현대,47,3,1,2,33.3,0,0
김주형,74605,KIA,36,2,1,1,50.0,0,0
손지환,97103,KIA,102,2,1,1,50.0,0,0
이강서,77600,KIA,15,1,1,0,100,0,0
한규식,99554,KIA,26,1,1,0,100,0,0
김진수,98540,두산,45,2,1,1,50.0,0,0
안경현,92207,두산,109,1,1,0,100,0,0
최준석,71552,두산,121,1,1,0,100,0,0
이재원,76812,SK,66,1,1,0,100,0,0
정상호,71842,SK,66,1,1,0,100,0,0
강민호,74540,롯데,125,5,1,4,20.0,0,0
박현승,95518,롯데,91,4,1,3,25.0,0,0
이대호,71564,롯데,121,1,1,0,100,0,0
최기문,96224,롯데,58,1,1,0,100,0,0
최길성,70649,롯데,56,1,1,0,100,0,0
페레즈,73559,롯데,47,2,1,1,50.0,0,0
홍유택,76515,롯데,6,1,1,0,100,0,0
손인호,98538,LG,39,2,1,1,50.0,0,0
안치용,72161,LG,12,1,1,0,100,0,0
조인성,98144,LG,124,2,1,1,50.0,0,0
최동수,94132,LG,125,2,1,1,50.0,0,0
권오준,99445,삼성,1,0,0,0,-,0,0
김대익,96503,삼성,69,1,0,1,0.0,0,0
김동명,77462,삼성,1,0,0,0,-,0,0
김종훈,94539,삼성,63,1,0,1,0.0,0,0
김한수,94450,삼성,101,2,0,2,0.0,0,0
박종호,92906,삼성,17,0,0,0,-,0,0
손승현,75442,삼성,3,0,0,0,-,0,0
오승환,75421,삼성,5,0,0,0,-,0,0
유용목,75404,삼성,5,0,0,0,-,0,0
이여상,76435,삼성,4,0,0,0,-,0,0
이정식,74402,삼성,65,0,0,0,-,0,0
이태호,72448,삼성,45,1,0,1,0.0,0,0
임창용,95657,삼성,2,0,0,0,-,0,0
정현욱,96462,삼성,1,0,0,0,-,0,0
조현근,75268,삼성,1,0,0,0,-,0,0
진갑용,97202,삼성,122,1,0,1,0.0,0,0
차우찬,76455,삼성,2,0,0,0,-,0,0
채태인,77463,삼성,31,0,0,0,-,0,0
현재윤,72427,삼성,6,0,0,0,-,0,0
구대성,93715,한화,2,0,0,0,-,0,0
김강,77733,한화,1,0,0,0,-,0,0
김인철,90811,한화,77,1,0,1,0.0,0,0
김태완,76746,한화,61,0,0,0,-,0,0
마정길,72749,한화,1,0,0,0,-,0,0
백승룡,75705,한화,8,0,0,0,-,0,0
백재호,97709,한화,80,0,0,0,-,0,0
서정,77708,한화,1,0,0,0,-,0,0
송광민,76753,한화,30,1,0,1,0.0,0,0
안영명,73738,한화,2,0,0,0,-,0,0
연경흠,76743,한화,36,0,0,0,-,0,0
이도형,93225,한화,79,0,0,0,-,0,0
전현태,75706,한화,2,0,0,0,-,0,0
정범모,76720,한화,3,0,0,0,-,0,0
강귀태,72312,현대,55,0,0,0,-,0,0
강병식,72325,현대,91,1,0,1,0.0,0,0
강정호,76325,현대,20,0,0,0,-,0,0
권도영,73363,현대,7,0,0,0,-,0,0
김남형,77314,현대,5,0,0,0,-,0,0
김성태,70345,현대,1,0,0,0,-,0,0
노병오,72461,현대,3,0,0,0,-,0,0
노환수,73343,현대,1,0,0,0,-,0,0
박준수,70349,현대,2,0,0,0,-,0,0
송신영,99314,현대,5,0,0,0,-,0,0
오윤,70312,현대,30,0,0,0,-,0,0
유덕형,75392,현대,3,0,0,0,-,0,0
유선정,76322,현대,5,0,0,0,-,0,0
이동학,70356,현대,1,0,0,0,-,0,0
이보근,75342,현대,1,0,0,0,-,0,0
이상열,96720,현대,1,0,0,0,-,0,0
이승주,74346,현대,9,0,0,0,-,0,0
이현승,76329,현대,3,0,0,0,-,0,0
전근표,70364,현대,4,0,0,0,-,0,0
조용훈,76357,현대,2,0,0,0,-,0,0
조중근,71835,현대,22,0,0,0,-,0,0
조평호,74358,현대,8,0,0,0,-,0,0
지석훈,73306,현대,89,3,0,3,0.0,0,0
허준,75344,현대,35,0,0,0,-,0,0
홍원기,96723,현대,25,0,0,0,-,0,0
황두성,97423,현대,1,0,0,0,-,0,0
권윤민,77632,KIA,11,0,0,0,-,0,0
김건한,71851,KIA,1,0,0,0,-,0,0
김경진,99614,KIA,28,0,0,0,-,0,0
김정수,75662,KIA,3,0,0,0,-,0,0
서튼,75333,KIA,34,0,0,0,-,0,0
심재학,95114,KIA,25,0,0,0,-,0,0
양현종,77637,KIA,3,0,0,0,-,0,0
유재원,76656,KIA,10,0,0,0,-,0,0
이상화,74647,KIA,1,0,0,0,-,0,0
이재주,92304,KIA,90,2,0,2,0.0,0,0
이호신,77648,KIA,21,0,0,0,-,0,0
조경환,98533,KIA,64,2,0,2,0.0,0,0
차일목,73602,KIA,41,0,0,0,-,0,0
차정민,75663,KIA,1,0,0,0,-,0,0
최훈락,75608,KIA,22,0,0,0,-,0,0
한기주,76610,KIA,2,0,0,0,-,0,0
홍세완,70626,KIA,59,2,0,2,0.0,0,0
강동우,98420,두산,25,1,0,1,0.0,0,0
금민철,75258,두산,5,0,0,0,-,0,0
김덕윤,71440,두산,2,0,0,0,-,0,0
김명제,75255,두산,3,0,0,0,-,0,0
김상현,71255,두산,2,0,0,0,-,0,0
김승회,73248,두산,1,0,0,0,-,0,0
김하람,75253,두산,1,0,0,0,-,0,0
김혜겸,74246,두산,8,0,0,0,-,0,0
노경은,73211,두산,2,0,0,0,-,0,0
안상준,95666,두산,46,0,0,0,-,0,0
양의지,76232,두산,3,0,0,0,-,0,0
원용묵,76262,두산,1,0,0,0,-,0,0
유재웅,72220,두산,20,0,0,0,-,0,0
윤석민,74215,두산,30,0,0,0,-,0,0
이경필,97230,두산,3,0,0,0,-,0,0
이두환,77242,두산,1,0,0,0,-,0,0
이승학,77257,두산,5,0,0,0,-,0,0
임태훈,77251,두산,9,0,0,0,-,0,0
장원진,92211,두산,23,0,0,0,-,0,0
정재훈,76240,두산,7,0,0,0,-,0,0
정재훈,73241,두산,11,0,0,0,-,0,0
최주환,76267,두산,3,0,0,0,-,0,0
허도환,77243,두산,1,0,0,0,-,0,0
홍성흔,99222,두산,80,2,0,2,0.0,0,0
가득염,92501,SK,4,0,0,0,-,0,0
강혁,99210,SK,10,0,0,0,-,0,0
김경태,98128,SK,1,0,0,0,-,0,0
김광현,77829,SK,1,0,0,0,-,0,0
김동건,71806,SK,10,0,0,0,-,0,0
김성현,76802,SK,3,1,0,1,0.0,0,0
김용섭,76868,SK,1,0,0,0,-,0,0
김원형,91848,SK,3,0,0,0,-,0,0
김재구,72850,SK,24,0,0,0,-,0,0
김재현,76869,SK,3,0,0,0,-,0,0
김태균,94415,SK,23,0,0,0,-,0,0
김형철,73827,SK,2,0,0,0,-,0,0
레이번,77860,SK,1,0,0,0,-,0,0
로마노,77868,SK,3,0,0,0,-,0,0
박연수,98130,SK,8,0,0,0,-,0,0
송은범,73801,SK,2,0,0,0,-,0,0
윤길현,72862,SK,1,0,0,0,-,0,0
이영욱,73825,SK,1,0,0,0,-,0,0
이한진,76822,SK,3,0,0,0,-,0,0
정대현,71801,SK,7,0,0,0,-,0,0
정우람,74857,SK,1,0,0,0,-,0,0
조웅천,90350,SK,6,0,0,0,-,0,0
채종국,98315,SK,23,0,0,0,-,0,0
김문호,76509,롯데,27,1,0,1,0.0,0,0
김민성,77564,롯데,4,0,0,0,-,0,0
김승관,95468,롯데,5,0,0,0,-,0,0
나승현,76529,롯데,1,0,0,0,-,0,0
리오스,77503,롯데,38,1,0,1,0.0,0,0
문규현,72546,롯데,25,0,0,0,-,0,0
박남섭,71815,롯데,75,0,0,0,-,0,0
박종윤,71562,롯데,8,0,0,0,-,0,0
박지철,94545,롯데,3,0,0,0,-,0,0
서정호,74564,롯데,3,0,0,0,-,0,0
손광민,77532,롯데,4,0,0,0,-,0,0
손용석,76536,롯데,44,1,0,1,0.0,0,0
이동훈,75554,롯데,3,0,0,0,-,0,0
이승재,76553,롯데,3,0,0,0,-,0,0
이창석,77552,롯데,3,0,0,0,-,0,0
최경환,70117,롯데,36,0,0,0,-,0,0
카브레라,74828,롯데,2,0,0,0,-,0,0
허준혁,74556,롯데,1,0,0,0,-,0,0
호세,99534,롯데,23,0,0,0,-,0,0
황성용,76562,롯데,69,1,0,1,0.0,0,0
경헌호,70121,LG,1,0,0,0,-,0,0
김민기,97111,LG,1,0,0,0,-,0,0
김용우,72131,LG,41,0,0,0,-,0,0
김우석,72108,LG,2,0,0,0,-,0,0
김재현,98776,LG,1,0,0,0,-,0,0
김회권,76169,LG,1,0,0,0,-,0,0
류택현,94228,LG,1,0,0,0,-,0,0
마해영,95549,LG,11,0,0,0,-,0,0
민경수,74130,LG,1,0,0,0,-,0,0
박영복,72154,LG,1,0,0,0,-,0,0
송현우,74160,LG,1,0,0,0,-,0,0
신윤호,94126,LG,1,0,0,0,-,0,0
심수창,74167,LG,6,0,0,0,-,0,0
안재만,97157,LG,10,0,0,0,-,0,0
양현석,70608,LG,3,0,0,0,-,0,0
우규민,73117,LG,5,0,0,0,-,0,0
정재복,73166,LG,2,0,0,0,-,0,0
최승준,76158,LG,4,0,0,0,-,0,0
최승환,70122,LG,22,0,0,0,-,0,0
추승우,72139,LG,1,0,0,0,-,0,0
황선일,76404,LG,44,0,0,0,-,0,0
