선수명,ID,팀명,경기,도루시도,도루허용,도루실패,도루성공률,주루사,견제사
이대형,73153,LG,133,82,64,18,78.0,0,0
정근우,75808,SK,127,66,53,13,80.3,0,0
이택근,73342,히어로즈,123,51,43,8,84.3,0,0
이종욱,73339,두산,82,43,37,6,86.0,0,0
김주찬,70410,롯데,109,41,34,7,82.9,0,0
박재상,71857,SK,133,44,33,11,75.0,0,0
김일경,97300,히어로즈,107,42,30,12,71.4,0,0
황재균,76313,히어로즈,133,45,30,15,66.7,0,0
강동우,98420,한화,128,30,27,3,90.0,0,0
클락,78725,히어로즈,125,31,23,8,74.2,0,0
박용택,72133,LG,111,25,22,3,88.0,0,0
나주환,73209,SK,118,30,21,9,70.0,0,0
신명철,71504,삼성,124,27,21,6,77.8,0,0
조동찬,72466,삼성,75,22,21,1,95.5,0,0
정수성,97350,히어로즈,87,27,21,6,77.8,0,0
강봉규,70224,삼성,126,23,20,3,87.0,0,0
김원섭,71207,KIA,101,30,20,10,66.7,0,0
박용근,77104,LG,101,25,19,6,76.0,0,0
민병헌,76249,두산,115,23,18,5,78.3,0,0
김상수,79402,삼성,97,24,18,6,75.0,0,0
이영욱,78467,삼성,88,20,16,4,80.0,0,0
박재홍,96362,SK,113,19,15,4,78.9,0,0
추승우,72139,한화,105,19,15,4,78.9,0,0
정수빈,79231,두산,85,20,13,7,65.0,0,0
조성환,99543,롯데,76,15,13,2,86.7,0,0
고영민,72214,두산,85,16,12,4,75.0,0,0
오재원,77248,두산,106,15,12,3,80.0,0,0
이승화,71565,롯데,102,15,12,3,80.0,0,0
최정,75847,SK,99,11,11,0,100,0,0
임재철,99507,두산,121,16,11,5,68.8,0,0
이종범,93607,KIA,123,12,11,1,91.7,0,0
이현곤,72606,KIA,120,14,11,3,78.6,0,0
김강민,71837,SK,104,17,10,7,58.8,0,0
이용규,74163,KIA,50,14,10,4,71.4,0,0
송지만,96761,히어로즈,115,13,10,3,76.9,0,0
홍성흔,99222,롯데,119,12,9,3,75.0,0,0
김민우,72303,히어로즈,78,9,9,0,100,0,0
김재현,94107,SK,112,9,8,1,88.9,0,0
김선빈,78603,KIA,72,10,8,2,80.0,0,0
안치홍,79608,KIA,123,13,8,5,61.5,0,0
이숭용,94310,히어로즈,114,11,8,3,72.7,0,0
조동화,71848,SK,102,10,7,3,70.0,0,0
박기혁,70553,롯데,109,13,7,6,53.8,0,0
박한이,71432,삼성,110,12,7,5,58.3,0,0
김상현,70646,KIA,121,12,7,5,58.3,0,0
장성호,96610,KIA,88,12,7,5,58.3,0,0
최용규,78666,KIA,51,12,7,5,58.3,0,0
김현수,76290,두산,133,12,6,6,50.0,0,0
손시헌,73213,두산,121,9,6,3,66.7,0,0
이인구,73563,롯데,95,12,6,6,50.0,0,0
박경수,73113,LG,106,10,6,4,60.0,0,0
모창민,78813,SK,92,12,5,7,41.7,0,0
박정권,74846,SK,131,9,5,4,55.6,0,0
김민성,77564,롯데,114,10,5,5,50.0,0,0
우동균,78454,삼성,76,7,5,2,71.4,0,0
송광민,76753,한화,116,5,5,0,100,0,0
장기영,71347,히어로즈,15,5,5,0,100,0,0
권용관,95158,LG,128,8,5,3,62.5,0,0
이진영,99810,LG,120,7,5,2,71.4,0,0
정성훈,99606,LG,121,5,5,0,100,0,0
김연훈,77609,SK,68,6,4,2,66.7,0,0
김재호,74206,두산,80,5,4,1,80.0,0,0
가르시아,78595,롯데,130,7,4,3,57.1,0,0
김재걸,95409,삼성,64,6,4,2,66.7,0,0
현재윤,72427,삼성,99,9,4,5,44.4,0,0
이여상,76435,한화,79,5,4,1,80.0,0,0
나지완,78629,KIA,128,5,4,1,80.0,0,0
최경환,70117,KIA,47,4,4,0,100,0,0
박경완,92809,SK,65,4,3,1,75.0,0,0
윤상균,78892,SK,28,3,3,0,100,0,0
김동주,98218,두산,105,4,3,1,75.0,0,0
박정준,73543,롯데,63,7,3,4,42.9,0,0
장성우,78548,롯데,44,3,3,0,100,0,0
정수근,95208,롯데,15,3,3,0,100,0,0
양준혁,93410,삼성,82,7,3,4,42.9,0,0
오선진,78756,한화,79,5,3,2,60.0,0,0
이범호,70756,한화,126,4,3,1,75.0,0,0
강귀태,72312,히어로즈,114,5,3,2,60.0,0,0
강정호,76325,히어로즈,133,5,3,2,60.0,0,0
김태완,74158,LG,40,3,3,0,100,0,0
안치용,72161,LG,90,5,3,2,60.0,0,0
박정환,70408,SK,45,3,2,1,66.7,0,0
이성열,73136,두산,31,2,2,0,100,0,0
이원석,75566,두산,125,8,2,6,25.0,0,0
정보명,73513,롯데,86,5,2,3,40.0,0,0
박진만,96307,삼성,76,3,2,1,66.7,0,0
디아즈,79725,한화,62,3,2,1,66.7,0,0
연경흠,76743,한화,122,3,2,1,66.7,0,0
이영우,96734,한화,93,3,2,1,66.7,0,0
한윤섭,78762,한화,22,3,2,1,66.7,0,0
김상훈,70612,KIA,124,3,2,1,66.7,0,0
김종국,96616,KIA,51,2,2,0,100,0,0
박기남,74103,KIA,104,2,2,0,100,0,0
신종길,72559,KIA,16,3,2,1,66.7,0,0
이성우,71184,KIA,13,2,2,0,100,0,0
차일목,73602,KIA,57,4,2,2,50.0,0,0
최희섭,77623,KIA,131,6,2,4,33.3,0,0
홍세완,70626,KIA,74,4,2,2,50.0,0,0
강병식,72325,히어로즈,54,4,2,2,50.0,0,0
브룸바,73324,히어로즈,123,4,2,2,50.0,0,0
전준호,91511,히어로즈,21,6,2,4,33.3,0,0
박병호,75125,LG,68,3,2,1,66.7,0,0
페타지니,78129,LG,115,2,2,0,100,0,0
손지환,97103,SK,6,1,1,0,100,0,0
이대수,72860,두산,38,2,1,1,50.0,0,0
최승환,70122,두산,84,1,1,0,100,0,0
최준석,71552,두산,116,1,1,0,100,0,0
박남섭,71815,롯데,40,1,1,0,100,0,0
손아섭,77532,롯데,34,2,1,1,50.0,0,0
전준우,78513,롯데,26,1,1,0,100,0,0
최기문,96224,롯데,54,1,1,0,100,0,0
최만호,97351,롯데,13,1,1,0,100,0,0
김창희,97644,삼성,71,3,1,2,33.3,0,0
진갑용,97202,삼성,57,3,1,2,33.3,0,0
최형우,72443,삼성,113,3,1,2,33.3,0,0
허승민,78458,삼성,21,3,1,2,33.3,0,0
김민재,91523,한화,105,2,1,1,50.0,0,0
김태완,76746,한화,112,2,1,1,50.0,0,0
박노민,74756,한화,46,1,1,0,100,0,0
정현석,78745,한화,24,1,1,0,100,0,0
이호신,77648,KIA,13,2,1,1,50.0,0,0
권도영,73363,히어로즈,38,1,1,0,100,0,0
박영복,72154,LG,13,2,1,1,50.0,0,0
손인호,98538,LG,61,4,1,3,25.0,0,0
임도현,78128,LG,15,2,1,1,50.0,0,0
최동수,94132,LG,108,1,1,0,100,0,0
권영진,78863,SK,2,0,0,0,-,0,0
김광현,77829,SK,1,0,0,0,-,0,0
김기현,77869,SK,1,0,0,0,-,0,0
김동건,71806,SK,4,0,0,0,-,0,0
김용우,72131,SK,4,0,0,0,-,0,0
김원형,91848,SK,1,0,0,0,-,0,0
김정남,79868,SK,15,0,0,0,-,0,0
안경현,92207,SK,42,0,0,0,-,0,0
엄정욱,70855,SK,1,0,0,0,-,0,0
오현근,78850,SK,4,0,0,0,-,0,0
윤길현,72862,SK,3,0,0,0,-,0,0
윤재국,98808,SK,26,0,0,0,-,0,0
이명기,76849,SK,4,1,0,1,0.0,0,0
이승호,99137,SK,1,0,0,0,-,0,0
이승호,70820,SK,1,0,0,0,-,0,0
이재원,76812,SK,24,0,0,0,-,0,0
이호준,94629,SK,103,0,0,0,-,0,0
임성헌,78843,SK,2,0,0,0,-,0,0
정경배,96441,SK,31,0,0,0,-,0,0
정대현,71801,SK,4,0,0,0,-,0,0
정상호,71842,SK,101,4,0,4,0.0,0,0
정우람,74857,SK,3,0,0,0,-,0,0
채병용,71845,SK,1,0,0,0,-,0,0
카도쿠라,79854,SK,1,0,0,0,-,0,0
하지호,79804,SK,2,0,0,0,-,0,0
허일상,72522,SK,2,0,0,0,-,0,0
고창성,78248,두산,4,0,0,0,-,0,0
금민철,75258,두산,2,0,0,0,-,0,0
김명제,75255,두산,2,0,0,0,-,0,0
김상현,71255,두산,1,0,0,0,-,0,0
김성배,73226,두산,1,0,0,0,-,0,0
김진수,98540,두산,30,0,0,0,-,0,0
박건우,79215,두산,5,0,0,0,-,0,0
박정배,75250,두산,1,0,0,0,-,0,0
오현택,79293,두산,2,0,0,0,-,0,0
왓슨,79225,두산,10,0,0,0,-,0,0
용덕한,74223,두산,79,2,0,2,0.0,0,0
유재웅,72220,두산,66,0,0,0,-,0,0
이용찬,77211,두산,8,0,0,0,-,0,0
이재우,71260,두산,2,0,0,0,-,0,0
임태훈,77251,두산,3,0,0,0,-,0,0
조승수,79235,두산,1,0,0,0,-,0,0
지승민,71715,두산,1,0,0,0,-,0,0
진야곱,78257,두산,1,0,0,0,-,0,0
최주환,76267,두산,9,0,0,0,-,0,0
강민호,74540,롯데,83,0,0,0,-,0,0
강영식,70615,롯데,1,0,0,0,-,0,0
김일엽,78543,롯데,1,0,0,0,-,0,0
문규현,72546,롯데,11,0,0,0,-,0,0
박종윤,71562,롯데,47,1,0,1,0.0,0,0
배장호,76540,롯데,1,0,0,0,-,0,0
서정호,74564,롯데,2,0,0,0,-,0,0
애킨스,79596,롯데,2,0,0,0,-,0,0
양종민,79530,롯데,6,0,0,0,-,0,0
오장훈,79544,롯데,3,1,0,1,0.0,0,0
이대호,71564,롯데,133,0,0,0,-,0,0
이동훈,75554,롯데,4,0,0,0,-,0,0
이정동,74548,롯데,1,0,0,0,-,0,0
이정민,72551,롯데,2,0,0,0,-,0,0
이정훈,97541,롯데,3,0,0,0,-,0,0
임경완,98521,롯데,2,0,0,0,-,0,0
장원준,74513,롯데,1,0,0,0,-,0,0
하준호,78517,롯데,1,0,0,0,-,0,0
권혁,72447,삼성,1,0,0,0,-,0,0
김동현,78413,삼성,2,0,0,0,-,0,0
박민규,79448,삼성,1,0,0,0,-,0,0
박석민,74465,삼성,97,0,0,0,-,0,0
백정현,77446,삼성,1,0,0,0,-,0,0
손주인,72456,삼성,80,3,0,3,0.0,0,0
심광호,96722,삼성,2,0,0,0,-,0,0
안지만,72463,삼성,1,0,0,0,-,0,0
오승환,75421,삼성,1,0,0,0,-,0,0
오정복,79453,삼성,6,0,0,0,-,0,0
이지영,79456,삼성,23,0,0,0,-,0,0
정형식,79459,삼성,1,0,0,0,-,0,0
조현근,75268,삼성,1,0,0,0,-,0,0
차우찬,76455,삼성,1,0,0,0,-,0,0
채상병,72742,삼성,49,0,0,0,-,0,0
채태인,77463,삼성,118,0,0,0,-,0,0
최원제,77466,삼성,1,0,0,0,-,0,0
강병수,79720,한화,16,0,0,0,-,0,0
구대성,93715,한화,2,0,0,0,-,0,0
김강,77733,한화,7,0,0,0,-,0,0
김강석,79704,한화,3,0,0,0,-,0,0
김태균,71752,한화,95,0,0,0,-,0,0
김회성,79705,한화,20,0,0,0,-,0,0
신경현,98742,한화,78,3,0,3,0.0,0,0
양승학,73856,한화,44,0,0,0,-,0,0
양훈,75750,한화,2,0,0,0,-,0,0
윤규진,73750,한화,1,0,0,0,-,0,0
이도형,93225,한화,98,0,0,0,-,0,0
이양기,73725,한화,15,0,0,0,-,0,0
이희근,78739,한화,42,0,0,0,-,0,0
최연오,77754,한화,5,0,0,0,-,0,0
최영필,97336,한화,1,0,0,0,-,0,0
최진행,74729,한화,28,0,0,0,-,0,0
토마스,78726,한화,2,0,0,0,-,0,0
고우석,73629,KIA,3,0,0,0,-,0,0
곽정철,75668,KIA,3,0,0,0,-,0,0
김경언,71610,KIA,2,0,0,0,-,0,0
김영수,97236,KIA,1,0,0,0,-,0,0
김형철,73827,KIA,6,0,0,0,-,0,0
박경태,76653,KIA,2,0,0,0,-,0,0
박정규,76638,KIA,1,0,0,0,-,0,0
손영민,76639,KIA,2,0,0,0,-,0,0
손정훈,79604,KIA,1,0,0,0,-,0,0
유동훈,99639,KIA,4,0,0,0,-,0,0
유용목,75404,KIA,2,0,0,0,-,0,0
윤석민,75620,KIA,3,0,0,0,-,0,0
이재주,92304,KIA,51,0,0,0,-,0,0
임준혁,73632,KIA,1,0,0,0,-,0,0
정성철,79621,KIA,2,0,0,0,-,0,0
김동수,90419,히어로즈,29,0,0,0,-,0,0
김지수,79300,히어로즈,15,0,0,0,-,0,0
손승현,75442,히어로즈,4,0,0,0,-,0,0
오윤,70312,히어로즈,19,0,0,0,-,0,0
오재일,75334,히어로즈,43,0,0,0,-,0,0
유선정,76322,히어로즈,33,0,0,0,-,0,0
유재신,76368,히어로즈,9,0,0,0,-,0,0
이보근,75342,히어로즈,1,0,0,0,-,0,0
장영석,79334,히어로즈,16,0,0,0,-,0,0
전동수,78361,히어로즈,4,0,0,0,-,0,0
조용훈,76357,히어로즈,1,0,0,0,-,0,0
조재호,72313,히어로즈,21,0,0,0,-,0,0
조중근,71835,히어로즈,17,0,0,0,-,0,0
허준,75344,히어로즈,40,0,0,0,-,0,0
황두성,97423,히어로즈,1,0,0,0,-,0,0
경헌호,70121,LG,1,0,0,0,-,0,0
곽용섭,73455,LG,6,0,0,0,-,0,0
김광삼,99152,LG,1,0,0,0,-,0,0
김민기,97111,LG,1,0,0,0,-,0,0
김정민,93112,LG,26,1,0,1,0.0,0,0
김태군,78122,LG,54,0,0,0,-,0,0
류택현,94228,LG,1,0,0,0,-,0,0
박종호,92906,LG,62,0,0,0,-,0,0
서동욱,73606,LG,5,0,0,0,-,0,0
오상민,97815,LG,1,0,0,0,-,0,0
오지환,79109,LG,5,0,0,0,-,0,0
오태근,72169,LG,8,0,0,0,-,0,0
우규민,73117,LG,3,0,0,0,-,0,0
윤진호,79198,LG,3,0,0,0,-,0,0
이경환,72253,LG,6,0,0,0,-,0,0
이동현,71118,LG,1,0,0,0,-,0,0
이병규,76100,LG,16,0,0,0,-,0,0
이재영,72216,LG,3,0,0,0,-,0,0
이종열,91015,LG,12,0,0,0,-,0,0
정주현,79150,LG,6,0,0,0,-,0,0
정찬헌,78148,LG,3,0,0,0,-,0,0
조인성,98144,LG,95,2,0,2,0.0,0,0
최동환,79140,LG,3,0,0,0,-,0,0
최성민,79137,LG,1,0,0,0,-,0,0
최원호,96345,LG,1,0,0,0,-,0,0
