선수명,ID,팀명,경기,도루시도,도루허용,도루실패,도루성공률,주루사,견제사
박해민,62415,삼성,141,67,52,15,77.6,6,2
손아섭,77532,롯데,144,46,42,4,91.3,10,1
이대형,73153,KT,143,57,37,20,64.9,2,2
고종욱,61353,넥센,133,42,28,14,66.7,9,2
김하성,64300,넥센,144,43,28,15,65.1,4,0
서건창,78168,넥센,140,39,26,13,66.7,9,1
황재균,76313,롯데,127,35,25,10,71.4,5,2
정근우,75808,한화,138,28,22,6,78.6,8,2
이용규,74163,한화,113,32,21,11,65.6,2,1
박민우,62907,NC,121,26,20,6,76.9,1,0
김호령,65653,KIA,124,29,19,10,65.5,8,2
김용의,78217,LG,105,26,19,7,73.1,4,1
히메네스,65103,LG,135,27,18,9,66.7,9,2
박건우,79215,두산,132,23,17,6,73.9,8,1
임병욱,64346,넥센,104,23,17,6,73.9,3,2
오지환,79109,LG,121,26,17,9,65.4,4,2
심우준,64006,KT,122,18,17,1,94.4,2,1
박정음,62353,넥센,98,25,16,9,64.0,4,1
유재신,76368,넥센,93,23,16,7,69.6,0,0
고메즈,66805,SK,117,24,16,8,66.7,6,0
이종욱,73339,NC,134,18,15,3,83.3,4,0
아두치,65523,롯데,64,17,15,2,88.2,3,0
이명기,76849,SK,99,22,14,8,63.6,5,0
오재원,77248,두산,122,23,13,10,56.5,3,1
김종호,77454,NC,93,19,13,6,68.4,5,0
테임즈,64914,NC,123,17,13,4,76.5,4,1
김재현,76869,SK,100,20,13,7,65.0,2,0
정수빈,79231,두산,114,16,12,4,75.0,5,0
김강민,71837,SK,115,17,12,5,70.6,8,0
노수광,63704,KIA,77,14,12,2,85.7,0,2
김문호,76509,롯데,140,27,12,15,44.4,4,2
하준호,78517,KT,94,16,12,4,75.0,2,2
구자욱,62404,삼성,108,15,10,5,66.7,6,0
필,64699,KIA,132,13,10,3,76.9,4,2
민병헌,76249,두산,134,11,9,2,81.8,7,0
김주찬,70410,KIA,130,16,9,7,56.3,5,0
서동욱,73606,KIA,124,13,9,4,69.2,5,0
김재호,74206,두산,137,12,8,4,66.7,6,0
김재환,78224,두산,134,10,8,2,80.0,4,0
백상원,60456,삼성,132,11,8,3,72.7,4,0
이재율,66968,NC,32,9,8,1,88.9,0,0
최정민,62893,SK,88,12,8,4,66.7,2,1
이병규,76100,LG,103,13,8,5,61.5,4,1
임훈,74823,LG,60,12,8,4,66.7,0,0
정성훈,99606,LG,126,12,8,4,66.7,2,0
나성범,62947,NC,144,11,7,4,63.6,4,1
이택근,73342,넥센,127,11,7,4,63.6,4,1
강한울,64610,KIA,104,10,7,3,70.0,3,0
신종길,72559,KIA,75,11,7,4,63.6,2,0
정훈,60523,롯데,121,14,7,7,50.0,3,1
채은성,79192,LG,128,10,7,3,70.0,5,0
허경민,79240,두산,144,12,6,6,50.0,5,1
김상수,79402,삼성,105,10,6,4,60.0,1,1
이영욱,78467,삼성,104,9,6,3,66.7,0,0
김민성,77564,넥센,141,9,6,3,66.7,6,0
조동화,71848,SK,76,8,6,2,75.0,3,0
나지완,78629,KIA,118,9,6,3,66.7,4,0
윤정우,61652,KIA,46,7,6,1,85.7,1,2
오승택,60558,롯데,42,8,6,2,75.0,1,0
박용택,72133,LG,138,12,6,6,50.0,6,0
이천웅,61186,LG,103,15,6,9,40.0,1,1
배영섭,79465,삼성,93,13,5,8,38.5,4,2
이승엽,95436,삼성,142,7,5,2,71.4,3,0
김성욱,62934,NC,130,7,5,2,71.4,3,0
양성우,62797,한화,108,7,5,2,71.4,9,1
하주석,62700,한화,115,12,5,7,41.7,6,1
김동한,61204,롯데,78,6,5,1,83.3,5,0
문선재,79113,LG,52,5,5,0,100,3,1
손주인,72456,LG,122,9,5,4,55.6,10,1
정주현,79150,LG,99,10,5,5,50.0,5,1
전민수,78361,KT,74,7,5,2,71.4,2,2
박정권,74846,SK,125,4,4,0,100,2,0
강민호,74540,롯데,116,4,4,0,100,6,0
김민하,61554,롯데,46,4,4,0,100,0,0
유한준,74339,KT,110,5,4,1,80.0,3,0
류지혁,62234,두산,90,5,3,2,60.0,0,0
이지영,79456,삼성,129,5,3,2,60.0,7,0
최재원,63913,삼성,28,4,3,1,75.0,1,0
모창민,78813,NC,63,5,3,2,60.0,1,0
이상호,60566,NC,15,3,3,0,100,0,0
이호준,94629,NC,119,5,3,2,60.0,7,0
조영훈,75441,NC,109,6,3,3,50.0,0,0
박동원,79365,넥센,127,4,3,1,75.0,5,0
김성현,76802,SK,138,6,3,3,50.0,6,0
박재상,71857,SK,94,9,3,6,33.3,4,0
김경언,71610,한화,66,3,3,0,100,2,0
송광민,76753,한화,116,3,3,0,100,5,0
장민석,71347,한화,98,6,3,3,50.0,3,2
고영우,63636,KIA,63,5,3,2,60.0,0,1
김상호,62559,롯데,114,4,3,1,75.0,4,1
나경민,66508,롯데,35,6,3,3,50.0,0,0
박종윤,71562,롯데,73,5,3,2,60.0,1,0
전준우,78513,롯데,25,6,3,3,50.0,1,0
양석환,64153,LG,80,3,3,0,100,3,0
김선민,60496,KT,32,4,3,1,75.0,0,0
박경수,73113,KT,121,4,3,1,75.0,6,1
박세혁,62244,두산,87,4,2,2,50.0,1,0
양의지,76232,두산,108,2,2,0,100,8,0
조수행,66209,두산,66,5,2,3,40.0,2,0
최형우,72443,삼성,138,4,2,2,50.0,6,0
김준완,63920,NC,122,7,2,5,28.6,2,0
박석민,74465,NC,126,2,2,0,100,3,0
김지수,79300,넥센,81,4,2,2,50.0,1,1
윤석민,74215,넥센,92,5,2,3,40.0,2,0
김동엽,66838,SK,57,3,2,1,66.7,3,1
박승욱,62802,SK,36,3,2,1,66.7,2,0
정의윤,75151,SK,144,5,2,3,40.0,12,0
박찬호,64646,KIA,69,2,2,0,100,1,0
백용환,78643,KIA,80,3,2,1,66.7,1,0
김재유,65506,롯데,21,5,2,3,40.0,0,0
맥스웰,66523,롯데,23,4,2,2,50.0,1,0
문규현,72546,롯데,120,5,2,3,40.0,1,1
오현근,78850,롯데,19,2,2,0,100,1,0
이여상,76435,롯데,61,4,2,2,50.0,1,0
이우민,71565,롯데,52,4,2,2,50.0,0,1
황목치승,63077,LG,48,4,2,2,50.0,1,0
김민혁,64004,KT,26,3,2,1,66.7,0,0
김연훈,77609,KT,103,2,2,0,100,1,0
배병옥,64166,KT,65,3,2,1,66.7,1,1
이진영,99810,KT,115,7,2,5,28.6,7,1
국해성,79290,두산,58,2,1,1,50.0,1,0
오재일,75334,두산,105,1,1,0,100,5,0
김재현,64499,삼성,122,2,1,1,50.0,2,0
김정혁,61463,삼성,46,2,1,1,50.0,1,0
박한이,71432,삼성,110,1,1,0,100,2,0
최선호,64493,삼성,60,3,1,2,33.3,1,0
손시헌,73213,NC,110,1,1,0,100,5,0
황윤호,62908,NC,33,1,1,0,100,1,0
강지광,79130,넥센,40,4,1,3,25.0,0,1
대니돈,66306,넥센,129,1,1,0,100,3,0
홍성갑,61366,넥센,44,1,1,0,100,0,0
김민식,62864,SK,88,2,1,1,50.0,2,1
이재원,76812,SK,130,6,1,5,16.7,8,1
최정,75847,SK,141,3,1,2,33.3,1,1
한동민,62895,SK,6,1,1,0,100,0,0
김태균,71752,한화,144,1,1,0,100,7,0
로사리오,66740,한화,127,4,1,3,25.0,6,1
김민우,72303,KIA,19,1,1,0,100,0,0
김선빈,78603,KIA,6,2,1,1,50.0,0,0
김원섭,71207,KIA,37,1,1,0,100,1,0
김주형,74605,KIA,135,3,1,2,33.3,5,2
오준혁,61743,KIA,47,3,1,2,33.3,2,0
이범호,70756,KIA,138,2,1,1,50.0,5,0
이진영,66657,KIA,17,2,1,1,50.0,0,0
이호신,77648,KIA,51,2,1,1,50.0,2,0
최원준,66606,KIA,14,2,1,1,50.0,0,0
김주현,77669,롯데,21,1,1,0,100,0,0
박헌도,79356,롯데,37,1,1,0,100,0,0
서상우,62164,LG,56,1,1,0,100,1,0
안익훈,65115,LG,68,2,1,1,50.0,1,0
윤진호,79198,LG,34,1,1,0,100,0,0
이형종,78135,LG,61,1,1,0,100,5,2
김사연,78753,KT,20,3,1,2,33.3,0,0
남태혁,66052,KT,16,1,1,0,100,0,0
문상철,64007,KT,48,1,1,0,100,2,0
오정복,79453,KT,96,1,1,0,100,8,0
유민상,62265,KT,95,2,1,1,50.0,4,0
윤요섭,78892,KT,66,2,1,1,50.0,0,0
이해창,60343,KT,88,2,1,1,50.0,5,0
강동연,61295,두산,3,0,0,0,-,0,0
고봉재,66201,두산,1,0,0,0,-,0,0
고영민,72214,두산,8,0,0,0,-,0,0
김성배,73226,두산,1,0,0,0,-,0,0
김인태,63257,두산,14,0,0,0,-,0,0
서예일,66203,두산,31,0,0,0,-,0,0
에반스,66244,두산,118,0,0,0,-,6,0
이우성,63260,두산,2,0,0,0,-,0,0
이원석,75566,두산,7,0,0,0,-,0,0
이현승,76329,두산,2,0,0,0,-,0,0
이현호,61214,두산,4,0,0,0,-,0,0
정진철,65293,두산,2,0,0,0,-,0,0
정진호,61208,두산,31,2,0,2,0.0,0,0
진야곱,78257,두산,1,0,0,0,-,0,0
최용제,64213,두산,4,0,0,0,-,0,1
최재훈,78288,두산,22,0,0,0,-,1,0
최주환,76267,두산,85,0,0,0,-,1,0
함덕주,63248,두산,1,0,0,0,-,0,0
홍성흔,99222,두산,17,1,0,1,0.0,1,0
권정웅,65412,삼성,3,0,0,0,-,0,0
김태완,74158,삼성,34,0,0,0,-,0,0
나성용,61742,삼성,6,0,0,0,-,0,0
박계범,64468,삼성,5,0,0,0,-,0,0
발디리스,66452,삼성,44,0,0,0,-,3,0
성의준,62406,삼성,24,0,0,0,-,0,0
심창민,61411,삼성,1,0,0,0,-,0,0
안지만,72463,삼성,1,0,0,0,-,0,0
우동균,78454,삼성,33,0,0,0,-,0,0
이상훈,60724,삼성,8,0,0,0,-,0,0
이성규,66409,삼성,6,0,0,0,-,0,0
이정식,74402,삼성,7,0,0,0,-,0,0
이흥련,63440,삼성,85,0,0,0,-,1,0
임대한,66493,삼성,1,0,0,0,-,0,0
장필준,77927,삼성,1,0,0,0,-,0,0
조동찬,72466,삼성,90,1,0,1,0.0,3,0
황선도,66469,삼성,1,0,0,0,-,0,0
강구성,62917,NC,2,0,0,0,-,0,0
강민국,64906,NC,24,0,0,0,-,0,0
구창모,65933,NC,1,0,0,0,-,0,0
권희동,63963,NC,14,1,0,1,0.0,2,0
김선규,75852,NC,1,0,0,0,-,0,0
김진성,75867,NC,3,0,0,0,-,0,0
김태군,78122,NC,134,0,0,0,-,3,0
김태진,64984,NC,2,0,0,0,-,0,0
김학성,64960,NC,1,0,0,0,-,0,0
도태훈,66965,NC,6,0,0,0,-,0,0
민성기,78366,NC,1,0,0,0,-,0,0
박광열,64944,NC,13,0,0,0,-,0,0
박민석,78243,NC,1,0,0,0,-,0,0
박세웅,62926,NC,1,0,0,0,-,0,0
박준영,66928,NC,3,0,0,0,-,0,0
배재환,64995,NC,2,0,0,0,-,0,0
용덕한,74223,NC,88,0,0,0,-,0,0
원종현,76118,NC,2,0,0,0,-,0,0
윤병호,62016,NC,11,0,0,0,-,0,1
이민호,62929,NC,3,0,0,0,-,0,0
이재학,60263,NC,1,0,0,0,-,0,0
임정호,63959,NC,1,0,0,0,-,0,0
임창민,78352,NC,6,0,0,0,-,0,0
장현식,63950,NC,1,0,0,0,-,0,0
조평호,74358,NC,3,0,0,0,-,0,0
지석훈,73306,NC,141,2,0,2,0.0,3,0
최금강,62966,NC,1,0,0,0,-,0,0
김민준,63339,넥센,20,1,0,1,0.0,0,0
김세현,76350,넥센,2,0,0,0,-,0,0
김웅빈,65898,넥센,10,0,0,0,-,0,0
김재현,62332,넥센,56,0,0,0,-,0,0
김택형,65343,넥센,1,0,0,0,-,0,0
마정길,72749,넥센,1,0,0,0,-,0,0
박윤,77848,넥센,7,0,0,0,-,0,0
오주원,74359,넥센,1,0,0,0,-,0,0
이정훈,97541,넥센,1,0,0,0,-,0,0
장시윤,63360,넥센,9,0,0,0,-,0,0
장영석,79334,넥센,23,1,0,1,0.0,1,1
주효상,66354,넥센,12,0,0,0,-,1,0
지재옥,62302,넥센,7,0,0,0,-,1,0
채태인,77463,넥센,124,1,0,1,0.0,3,1
허정협,65399,넥센,13,0,0,0,-,0,0
김기현,77869,SK,14,0,0,0,-,0,0
김승회,73248,SK,1,0,0,0,-,0,0
김주한,66859,SK,3,0,0,0,-,0,0
김태훈,79847,SK,1,0,0,0,-,0,0
나주환,73209,SK,24,4,0,4,0.0,0,0
라라,66825,SK,1,0,0,0,-,0,0
문광은,60845,SK,1,0,0,0,-,0,0
박민호,64893,SK,3,0,0,0,-,0,0
박정배,75250,SK,3,0,0,0,-,0,0
박희수,76858,SK,5,0,0,0,-,0,0
신재웅,75138,SK,2,0,0,0,-,0,0
유서준,64890,SK,8,0,0,0,-,1,0
이건욱,64861,SK,1,0,0,0,-,0,0
이대수,72860,SK,14,0,0,0,-,0,0
이정담,61557,SK,1,0,0,0,-,0,0
이진석,64895,SK,41,0,0,0,-,1,1
이현석,65869,SK,11,0,0,0,-,1,0
임석진,66833,SK,11,0,0,0,-,0,0
전유수,75340,SK,3,0,0,0,-,0,0
정영일,62056,SK,2,0,0,0,-,0,0
조성모,64802,SK,3,0,0,0,-,0,0
조한욱,65827,SK,1,0,0,0,-,0,0
채병용,71845,SK,2,0,0,0,-,0,0
최승준,76158,SK,76,0,0,0,-,1,0
최정용,65464,SK,48,0,0,0,-,1,2
강경학,61700,한화,46,0,0,0,-,2,0
권용관,95158,한화,40,0,0,0,-,0,1
권혁,72447,한화,1,0,0,0,-,0,0
김경태,60757,한화,1,0,0,0,-,0,0
김원석,62768,한화,11,0,0,0,-,0,0
김주현,66749,한화,4,0,0,0,-,0,0
김태완,76746,한화,24,0,0,0,-,0,0
김회성,79705,한화,28,0,0,0,-,0,0
로저스,65742,한화,1,0,0,0,-,0,0
박노민,74756,한화,5,0,0,0,-,0,0
박정진,99737,한화,1,0,0,0,-,0,0
박준혁,64724,한화,6,0,0,0,-,0,0
송주호,60404,한화,33,2,0,2,0.0,0,0
송창식,74731,한화,1,0,0,0,-,0,0
신성현,64086,한화,89,4,0,4,0.0,2,0
오선진,78756,한화,57,0,0,0,-,0,0
윤규진,73750,한화,1,0,0,0,-,0,0
이동훈,66702,한화,17,0,0,0,-,0,0
이성열,73136,한화,86,0,0,0,-,2,0
이양기,73725,한화,17,0,0,0,-,0,0
이종환,60667,한화,31,0,0,0,-,0,0
이태양,60768,한화,1,0,0,0,-,0,0
임익준,77464,한화,3,0,0,0,-,0,0
장민재,79764,한화,2,0,0,0,-,0,0
장운호,63700,한화,51,0,0,0,-,0,0
정범모,76720,한화,5,0,0,0,-,0,0
정우람,74857,한화,2,0,0,0,-,0,0
정현석,78745,한화,3,0,0,0,-,0,0
조인성,98144,한화,76,0,0,0,-,0,0
주현상,65707,한화,15,0,0,0,-,0,0
지성준,64717,한화,1,0,0,0,-,0,0
차일목,73602,한화,117,0,0,0,-,4,0
최윤석,60805,한화,11,0,0,0,-,0,0
최진행,74729,한화,28,0,0,0,-,0,0
허도환,77243,한화,48,0,0,0,-,0,1
김광수,70142,KIA,1,0,0,0,-,0,0
김다원,78765,KIA,25,0,0,0,-,0,0
김윤동,62648,KIA,1,0,0,0,-,0,0
김진우,72641,KIA,2,0,0,0,-,0,0
박준표,63638,KIA,1,0,0,0,-,0,0
배힘찬,72321,KIA,1,0,0,0,-,0,0
심동섭,60636,KIA,2,0,0,0,-,0,0
안치홍,79608,KIA,10,0,0,0,-,1,0
윤완주,62668,KIA,34,0,0,0,-,0,0
이성우,71184,KIA,55,0,0,0,-,1,1
이홍구,63634,KIA,106,1,0,1,0.0,1,0
임창용,95657,KIA,2,0,0,0,-,0,0
전상현,66609,KIA,1,0,0,0,-,0,0
정용운,79617,KIA,1,0,0,0,-,0,0
최병연,60658,KIA,12,0,0,0,-,0,0
최영필,97336,KIA,1,0,0,0,-,0,0
한기주,76610,KIA,1,0,0,0,-,0,0
한승택,63722,KIA,27,0,0,0,-,0,0
한승혁,61666,KIA,2,0,0,0,-,0,0
헥터,66643,KIA,3,0,0,0,-,0,0
홍건희,61643,KIA,4,0,0,0,-,0,0
홍재호,60605,KIA,22,0,0,0,-,0,0
황대인,65610,KIA,4,0,0,0,-,0,0
강동관,65514,롯데,2,0,0,0,-,0,0
김대륙,65513,롯데,58,0,0,0,-,0,0
김대우,78536,롯데,2,0,0,0,-,0,0
김사훈,61591,롯데,19,0,0,0,-,1,0
김준태,62558,롯데,68,0,0,0,-,3,1
김지수,65503,롯데,6,0,0,0,-,0,0
레일리,65546,롯데,1,0,0,0,-,0,0
박시영,60559,롯데,2,0,0,0,-,0,0
손승락,75321,롯데,4,0,0,0,-,0,0
손용석,76536,롯데,51,0,0,0,-,0,0
신본기,62556,롯데,25,1,0,1,0.0,0,0
안중열,64022,롯데,19,0,0,0,-,0,0
윤길현,72862,롯데,1,0,0,0,-,0,0
이정민,72551,롯데,1,0,0,0,-,0,0
정대현,71801,롯데,1,0,0,0,-,0,0
최준석,71552,롯데,116,0,0,0,-,4,0
홍성민,62655,롯데,1,0,0,0,-,0,0
황진수,78566,롯데,11,1,0,1,0.0,0,0
강승호,63123,LG,18,0,0,0,-,0,0
김대현,66145,LG,1,0,0,0,-,0,0
김지성,62007,LG,2,0,0,0,-,0,0
박성준,65120,LG,1,0,0,0,-,0,0
박재욱,64100,LG,26,0,0,0,-,1,1
백창수,60100,LG,10,1,0,1,0.0,0,0
소사,62698,LG,2,0,0,0,-,0,0
유강남,61102,LG,100,0,0,0,-,2,0
윤지웅,61329,LG,1,0,0,0,-,0,0
이병규,97109,LG,1,0,0,0,-,0,0
이승현,60146,LG,3,0,0,0,-,0,0
임정우,61891,LG,4,0,0,0,-,0,0
장준원,64115,LG,14,0,0,0,-,0,0
정상호,71842,LG,77,1,0,1,0.0,0,0
정현욱,96462,LG,1,0,0,0,-,0,0
조윤준,62147,LG,2,0,0,0,-,0,0
진해수,76650,LG,1,0,0,0,-,0,0
최경철,73824,LG,29,0,0,0,-,3,0
최동환,79140,LG,1,0,0,0,-,0,0
홍창기,66108,LG,3,0,0,0,-,0,0
김동명,77462,KT,21,0,0,0,-,0,0
김만수,65044,KT,1,0,0,0,-,0,0
김사율,99563,KT,1,0,0,0,-,0,0
김상현,70646,KT,62,1,0,1,0.0,3,0
김영환,63448,KT,12,0,0,0,-,1,0
김재윤,65062,KT,3,0,0,0,-,0,0
김종민,79364,KT,78,0,0,0,-,4,1
김진곤,63088,KT,13,0,0,0,-,0,0
마르테,65005,KT,91,0,0,0,-,2,0
박기혁,70553,KT,117,2,0,2,0.0,3,0
박세진,66047,KT,1,0,0,0,-,0,0
박용근,77104,KT,31,1,0,1,0.0,0,0
배우열,79191,KT,1,0,0,0,-,0,0
신현철,76304,KT,35,0,0,0,-,0,0
심재민,64017,KT,3,0,0,0,-,0,0
엄상백,65056,KT,2,0,0,0,-,0,0
정성곤,65058,KT,1,0,0,0,-,0,0
정주후,65096,KT,12,0,0,0,-,0,0
홍성무,65042,KT,1,0,0,0,-,0,0
홍성용,75149,KT,1,0,0,0,-,0,0
