선수명,ID,팀명,경기,도루시도,도루허용,도루실패,도루성공률,주루사,견제사
박해민,62415,삼성,144,52,40,12,76.9,3,2
버나디나,67650,KIA,139,39,32,7,82.1,8,1
손아섭,77532,롯데,144,33,25,8,75.8,4,0
이대형,73153,KT,100,27,23,4,85.2,0,2
박건우,79215,두산,131,23,20,3,87.0,3,1
나경민,66508,롯데,97,23,20,3,87.0,9,1
심우준,64006,KT,103,23,18,5,78.3,2,2
나성범,62947,NC,125,24,17,7,70.8,3,2
고종욱,61353,넥센,123,20,16,4,80.0,4,0
김하성,64300,넥센,141,24,16,8,66.7,6,0
노수광,63704,SK,131,25,16,9,64.0,2,1
서건창,78168,넥센,139,21,15,6,71.4,4,0
오태곤,60558,KT,135,24,15,9,62.5,5,1
이상호,60566,NC,95,14,12,2,85.7,4,1
이정후,67341,넥센,144,16,12,4,75.0,6,0
강한울,64610,삼성,135,19,12,7,63.2,4,0
박민우,62907,NC,106,12,11,1,91.7,4,0
이형종,78135,LG,128,17,11,6,64.7,2,0
조용호,64868,SK,69,13,11,2,84.6,3,1
김헌곤,61404,삼성,123,13,11,2,84.6,3,2
김성욱,62934,NC,124,14,10,4,71.4,2,0
오지환,79109,LG,107,15,10,5,66.7,4,1
김강민,71837,SK,88,14,10,4,71.4,0,1
로사리오,66740,한화,119,15,10,5,66.7,6,1
이용규,74163,한화,57,13,10,3,76.9,1,2
번즈,67598,롯데,116,17,10,7,58.8,12,2
구자욱,62404,삼성,144,14,10,4,71.4,3,0
모창민,78813,NC,136,15,9,6,60.0,6,1
이재율,66968,NC,52,10,9,1,90.0,2,1
이종욱,73339,NC,107,11,9,2,81.8,4,0
김용의,78217,LG,60,13,9,4,69.2,2,0
김주찬,70410,KIA,122,11,9,2,81.8,5,0
김문호,76509,롯데,131,13,9,4,69.2,5,0
하준호,78517,KT,101,14,9,5,64.3,3,1
허경민,79240,두산,130,12,8,4,66.7,3,0
이천웅,61186,LG,75,11,8,3,72.7,2,0
이명기,76849,KIA,115,15,8,7,53.3,2,0
장민석,71347,한화,88,12,8,4,66.7,3,1
김재호,74206,두산,91,8,7,1,87.5,4,2
류지혁,62234,두산,125,12,7,5,58.3,2,0
오재원,77248,두산,127,14,7,7,50.0,4,1
안치홍,79608,KIA,132,7,7,0,100,2,0
하주석,62700,한화,111,13,7,6,53.8,7,0
정근우,75808,한화,105,12,6,6,50.0,3,2
채은성,79192,LG,114,11,5,6,45.5,4,1
신본기,62556,롯데,128,7,5,2,71.4,2,2
로하스,67025,KT,83,13,5,8,38.5,4,0
김재환,78224,두산,144,5,4,1,80.0,4,0
스크럭스,67935,NC,115,4,4,0,100,7,1
박용택,72133,LG,138,6,4,2,66.7,7,0
손주인,72456,LG,115,4,4,0,100,2,0
정성훈,99606,LG,115,7,4,3,57.1,3,0
김선빈,78603,KIA,137,8,4,4,50.0,4,0
정진기,61869,SK,90,4,4,0,100,0,0
양성우,62797,한화,118,8,4,4,50.0,8,1
이동훈,66702,한화,67,6,4,2,66.7,0,0
김동한,61204,롯데,81,7,4,3,57.1,0,0
황진수,78566,롯데,60,4,4,0,100,0,0
김성훈,66462,삼성,47,6,4,2,66.7,1,0
이지영,79456,삼성,105,7,4,3,57.1,1,0
정현,63450,KT,124,6,4,2,66.7,3,1
민병헌,76249,두산,123,7,3,4,42.9,2,0
조수행,66209,두산,80,5,3,2,60.0,2,0
최주환,76267,두산,129,5,3,2,60.0,2,1
권희동,63963,NC,141,6,3,3,50.0,4,0
박정음,62353,넥센,81,7,3,4,42.9,4,0
안익훈,65115,LG,108,5,3,2,60.0,4,1
양석환,64153,LG,132,10,3,7,30.0,5,1
최재원,63913,LG,69,6,3,3,50.0,3,0
히메네스,65103,LG,51,8,3,5,37.5,2,0
김민식,62864,KIA,137,6,3,3,50.0,4,0
김호령,65653,KIA,98,5,3,2,60.0,0,0
유재신,76368,KIA,25,4,3,1,75.0,0,0
최원준,66606,KIA,72,5,3,2,60.0,4,1
이대수,72860,SK,58,3,3,0,100,2,0
오선진,78756,한화,65,8,3,5,37.5,0,0
이성열,73136,한화,81,3,3,0,100,4,1
정훈,60523,롯데,68,4,3,1,75.0,0,0
김정혁,61463,삼성,31,4,3,1,75.0,0,0
조동찬,72466,삼성,122,3,3,0,100,4,1
박세혁,62244,두산,97,3,2,1,66.7,2,0
에반스,66244,두산,138,2,2,0,100,1,0
김준완,63920,NC,104,4,2,2,50.0,2,0
윤병호,62016,NC,49,2,2,0,100,0,0
박동원,79365,넥센,103,3,2,1,66.7,7,0
임병욱,64346,넥센,21,2,2,0,100,1,0
강승호,63123,LG,85,4,2,2,50.0,1,2
유강남,61102,LG,118,2,2,0,100,1,0
황목치승,63077,LG,45,2,2,0,100,1,0
신종길,72559,KIA,64,3,2,1,66.7,0,1
김동엽,66838,SK,125,6,2,4,33.3,2,2
김성현,76802,SK,130,3,2,1,66.7,2,0
한동민,62895,SK,103,4,2,2,50.0,1,0
송광민,76753,한화,117,5,2,3,40.0,1,0
정경운,66716,한화,46,2,2,0,100,2,0
문규현,72546,롯데,110,3,2,1,66.7,1,1
이우민,71565,롯데,104,6,2,4,33.3,1,2
전준우,78513,롯데,110,6,2,4,33.3,2,1
러프,67450,삼성,134,4,2,2,50.0,12,0
이원석,75566,삼성,121,2,2,0,100,4,0
김사연,78753,KT,35,2,2,0,100,0,0
모넬,67024,KT,28,3,2,1,66.7,3,0
박기혁,70553,KT,97,3,2,1,66.7,4,0
전민수,78361,KT,55,3,2,1,66.7,1,0
신성현,64086,두산,34,1,1,0,100,0,0
양의지,76232,두산,111,2,1,1,50.0,3,0
오재일,75334,두산,128,2,1,1,50.0,1,1
정진호,61208,두산,97,2,1,1,50.0,2,2
김종호,77454,NC,3,1,1,0,100,0,0
박석민,74465,NC,101,3,1,2,33.3,4,0
손시헌,73213,NC,124,1,1,0,100,2,0
이호준,94629,NC,77,1,1,0,100,1,0
지석훈,73306,NC,121,1,1,0,100,4,0
채상현,66302,넥센,5,1,1,0,100,0,0
허정협,65399,넥센,83,3,1,2,33.3,0,0
백창수,60100,LG,52,1,1,0,100,1,2
서상우,62164,LG,10,1,1,0,100,0,0
임훈,74823,LG,42,3,1,2,33.3,0,1
정주현,79150,LG,15,1,1,0,100,1,0
김지성,62007,KIA,37,1,1,0,100,1,0
나지완,78629,KIA,137,2,1,1,50.0,4,2
서동욱,73606,KIA,125,2,1,1,50.0,3,0
김재현,76869,SK,14,3,1,2,33.3,0,0
로맥,67872,SK,102,2,1,1,50.0,3,1
박정권,74846,SK,118,2,1,1,50.0,2,0
최정,75847,SK,130,6,1,5,16.7,0,0
강경학,61700,한화,59,2,1,1,50.0,0,1
김경언,71610,한화,38,1,1,0,100,1,0
임익준,77464,한화,30,1,1,0,100,1,0
차일목,73602,한화,52,2,1,1,50.0,0,0
김사훈,61591,롯데,57,1,1,0,100,0,0
이대호,71564,롯데,142,2,1,1,50.0,4,0
김상수,79402,삼성,42,2,1,1,50.0,3,0
배영섭,79465,삼성,92,1,1,0,100,2,0
안주형,66406,삼성,10,2,1,1,50.0,2,0
이승엽,95436,삼성,135,2,1,1,50.0,9,1
이현동,62499,삼성,16,1,1,0,100,0,0
정병곤,61104,삼성,74,1,1,0,100,0,0
최영진,61197,삼성,14,1,1,0,100,0,0
김동욱,77462,KT,83,1,1,0,100,3,0
김진곤,63088,KT,28,1,1,0,100,1,0
박경수,73113,KT,131,3,1,2,33.3,7,0
안치영,67006,KT,21,3,1,2,33.3,1,0
유민상,62265,KT,15,1,1,0,100,0,0
이해창,60343,KT,114,5,1,4,20.0,4,1
정주후,65096,KT,7,1,1,0,100,0,0
홍현빈,67005,KT,8,1,1,0,100,0,0
국해성,79290,두산,57,0,0,0,-,0,0
김강률,77263,두산,3,0,0,0,-,0,0
김명신,67246,두산,1,0,0,0,-,0,0
김민혁,65269,두산,18,0,0,0,-,0,0
김인태,63257,두산,31,0,0,0,-,1,0
박유연,67202,두산,3,0,0,0,-,0,0
서예일,66203,두산,22,0,0,0,-,0,0
이성곤,64266,두산,4,0,0,0,-,0,0
이용찬,77211,두산,4,0,0,0,-,0,0
이우성,63260,두산,2,0,0,0,-,0,0
황경태,66207,두산,2,0,0,0,-,0,0
강구성,62917,NC,1,0,0,0,-,0,0
강윤구,79358,NC,2,0,0,0,-,0,0
강진성,62925,NC,28,0,0,0,-,1,0
김종민,79364,NC,22,0,0,0,-,0,0
김진성,75867,NC,1,0,0,0,-,0,0
김찬형,66917,NC,2,0,0,0,-,0,0
김태군,78122,NC,132,1,0,1,0.0,4,0
김태우,62927,NC,3,0,0,0,-,0,0
노진혁,62931,NC,4,0,0,0,-,0,0
도태훈,66965,NC,32,0,0,0,-,1,0
박광열,64944,NC,60,0,0,0,-,1,0
신진호,67944,NC,9,0,0,0,-,0,0
원종현,76118,NC,1,0,0,0,-,0,0
유영준,63903,NC,2,0,0,0,-,0,0
윤수호,65064,NC,8,0,0,0,-,0,0
이민호,62929,NC,4,0,0,0,-,0,0
이원재,62025,NC,2,0,0,0,-,0,0
이재학,60263,NC,1,0,0,0,-,0,0
이형범,62951,NC,2,0,0,0,-,0,0
임정호,63959,NC,2,0,0,0,-,0,0
임창민,78352,NC,3,0,0,0,-,0,0
장현식,63950,NC,1,0,0,0,-,0,0
정수민,66960,NC,1,0,0,0,-,0,0
조영훈,75441,NC,16,0,0,0,-,0,0
조평호,74358,NC,29,1,0,1,0.0,0,0
최금강,62966,NC,1,0,0,0,-,0,0
최성영,66920,NC,2,0,0,0,-,0,0
황윤호,62908,NC,36,0,0,0,-,3,1
강지광,79130,넥센,1,0,0,0,-,0,0
김규민,62356,넥센,14,0,0,0,-,0,0
김민성,77564,넥센,133,1,0,1,0.0,2,0
김민준,63339,넥센,12,0,0,0,-,0,0
김상수,76430,넥센,1,0,0,0,-,0,0
김웅빈,65898,넥센,67,0,0,0,-,1,0
김재현,62332,넥센,70,0,0,0,-,1,0
김지수,79300,넥센,64,1,0,1,0.0,2,0
김태완,76746,넥센,46,0,0,0,-,0,1
김혜성,67304,넥센,16,0,0,0,-,0,0
대니돈,66306,넥센,20,0,0,0,-,1,0
박윤,77848,넥센,9,0,0,0,-,0,0
송성문,65357,넥센,38,1,0,1,0.0,1,0
이택근,73342,넥센,100,0,0,0,-,1,0
장영석,79334,넥센,60,0,0,0,-,2,0
주효상,66354,넥센,64,0,0,0,-,5,0
채태인,77463,넥센,109,1,0,1,0.0,3,1
초이스,67394,넥센,46,0,0,0,-,2,0
하영민,64350,넥센,1,0,0,0,-,0,0
한현희,62363,넥센,1,0,0,0,-,0,0
홍성갑,61366,넥센,7,0,0,0,-,0,0
고우석,67119,LG,1,0,0,0,-,0,0
김대현,66145,LG,1,0,0,0,-,0,0
김재율,61114,LG,75,1,0,1,0.0,1,0
김주성,66162,LG,2,0,0,0,-,0,0
김지용,60181,LG,1,0,0,0,-,0,0
로니,67134,LG,23,0,0,0,-,1,0
문선재,79113,LG,35,3,0,3,0.0,1,0
백승현,65109,LG,9,1,0,1,0.0,0,0
신정락,60140,LG,2,0,0,0,-,0,0
유재유,66160,LG,1,0,0,0,-,0,0
윤지웅,61329,LG,1,0,0,0,-,0,0
윤진호,79198,LG,14,0,0,0,-,0,0
이동현,71118,LG,1,0,0,0,-,0,0
이병규,76100,LG,19,0,0,0,-,0,0
장준원,64115,LG,8,0,0,0,-,0,0
정상호,71842,LG,79,0,0,0,-,1,0
정찬헌,78148,LG,1,0,0,0,-,0,0
조윤준,62147,LG,25,0,0,0,-,1,0
진해수,76650,LG,1,0,0,0,-,0,0
차우찬,76455,LG,1,0,0,0,-,0,0
최동환,79140,LG,4,0,0,0,-,0,0
최민창,65157,LG,13,1,0,1,0.0,0,0
고장혁,63636,KIA,67,1,0,1,0.0,2,0
고효준,72523,KIA,1,0,0,0,-,0,0
김광수,70142,KIA,4,0,0,0,-,0,0
김세현,76350,KIA,1,0,0,0,-,0,0
김윤동,62648,KIA,2,0,0,0,-,0,0
김주형,74605,KIA,57,0,0,0,-,0,0
김진우,72641,KIA,1,0,0,0,-,0,0
노관현,66804,KIA,9,0,0,0,-,0,0
박지훈,62637,KIA,1,0,0,0,-,0,0
박진태,67646,KIA,7,0,0,0,-,0,0
백용환,78643,KIA,15,0,0,0,-,1,0
손영민,76639,KIA,2,0,0,0,-,0,0
심동섭,60636,KIA,5,0,0,0,-,0,0
오준혁,61743,KIA,14,0,0,0,-,0,0
이범호,70756,KIA,115,0,0,0,-,2,1
이인행,60648,KIA,3,0,0,0,-,0,0
이정훈,67644,KIA,4,0,0,0,-,0,0
이진영,66657,KIA,18,1,0,1,0.0,0,1
이호신,77648,KIA,12,1,0,1,0.0,0,0
임기영,62754,KIA,1,0,0,0,-,0,0
임기준,60634,KIA,1,0,0,0,-,0,0
임창용,95657,KIA,4,0,0,0,-,0,0
최병연,60658,KIA,3,0,0,0,-,0,0
최영필,97336,KIA,1,0,0,0,-,0,0
최정민,62893,KIA,8,0,0,0,-,0,0
최형우,72443,KIA,142,1,0,1,0.0,3,0
한승택,63722,KIA,96,0,0,0,-,1,0
한승혁,61666,KIA,6,0,0,0,-,0,0
홍건희,61643,KIA,2,0,0,0,-,0,0
홍재호,60605,KIA,2,0,0,0,-,0,0
김주한,66859,SK,2,0,0,0,-,0,0
나주환,73209,SK,122,3,0,3,0.0,2,0
박성한,67893,SK,2,0,0,0,-,0,0
박승욱,62802,SK,73,4,0,4,0.0,1,0
서진용,61895,SK,1,0,0,0,-,0,0
워스,67827,SK,3,0,0,0,-,0,0
이성우,71184,SK,64,0,0,0,-,0,0
이재원,76812,SK,114,1,0,1,0.0,3,0
이홍구,63634,SK,53,0,0,0,-,0,0
전유수,75340,SK,1,0,0,0,-,0,0
정의윤,75151,SK,112,1,0,1,0.0,5,1
최승준,76158,SK,31,0,0,0,-,2,0
최정용,65464,SK,5,1,0,1,0.0,1,0
최항,62884,SK,37,1,0,1,0.0,2,1
허건엽,62892,SK,1,0,0,0,-,0,0
강상원,66710,한화,33,0,0,0,-,0,0
강승현,78552,한화,1,0,0,0,-,0,0
김원석,62768,한화,78,0,0,0,-,6,1
김주현,66749,한화,24,0,0,0,-,2,1
김태균,71752,한화,94,0,0,0,-,3,1
김태연,66704,한화,12,0,0,0,-,0,0
김회성,79705,한화,54,0,0,0,-,0,0
박상언,66707,한화,4,0,0,0,-,0,0
박상원,67703,한화,1,0,0,0,-,0,0
박준혁,64724,한화,8,0,0,0,-,2,0
송신영,99314,한화,1,0,0,0,-,0,0
심수창,74167,한화,2,0,0,0,-,0,0
안영명,73738,한화,1,0,0,0,-,0,0
이동걸,77452,한화,1,0,0,0,-,0,0
이양기,73725,한화,17,0,0,0,-,0,0
이종환,60667,한화,1,0,0,0,-,0,0
이창열,64706,한화,3,0,0,0,-,0,0
정범모,76720,한화,22,0,0,0,-,0,0
정우람,74857,한화,1,0,0,0,-,0,0
정현석,78745,한화,9,0,0,0,-,0,0
조인성,98144,한화,16,0,0,0,-,0,0
최윤석,60805,한화,21,0,0,0,-,0,0
최재훈,78288,한화,104,2,0,2,0.0,4,0
최진행,74729,한화,89,2,0,2,0.0,3,0
허도환,77243,한화,30,0,0,0,-,1,0
강동관,65514,롯데,1,0,0,0,-,0,0
강민호,74540,롯데,130,2,0,2,0.0,3,0
김대륙,65513,롯데,50,0,0,0,-,1,0
김대우,78536,롯데,12,0,0,0,-,1,1
김민수,67504,롯데,10,0,0,0,-,0,0
김상호,62559,롯데,80,3,0,3,0.0,1,0
김재유,65506,롯데,1,0,0,0,-,0,0
김주현,77669,롯데,2,0,0,0,-,0,0
나종덕,67539,롯데,5,0,0,0,-,1,0
노경은,73211,롯데,2,0,0,0,-,0,0
박시영,60559,롯데,1,0,0,0,-,0,0
박헌도,79356,롯데,56,0,0,0,-,0,0
손승락,75321,롯데,4,0,0,0,-,0,0
윤길현,72862,롯데,1,0,0,0,-,0,0
이명우,72535,롯데,1,0,0,0,-,0,0
장시환,77318,롯데,2,0,0,0,-,0,0
최준석,71552,롯데,125,0,0,0,-,4,0
권정웅,65412,삼성,61,0,0,0,-,0,0
김동호,79791,삼성,1,0,0,0,-,0,0
김민수,64793,삼성,13,0,0,0,-,0,0
김성윤,67449,삼성,22,0,0,0,-,0,0
김승현,66492,삼성,1,0,0,0,-,0,0
나성용,61742,삼성,6,1,0,1,0.0,0,0
나원탁,67454,삼성,12,0,0,0,-,0,0
문선엽,60464,삼성,4,0,0,0,-,0,0
박근홍,74630,삼성,1,0,0,0,-,0,0
박한이,71432,삼성,68,0,0,0,-,1,0
백상원,60456,삼성,28,0,0,0,-,0,0
성의준,62406,삼성,11,0,0,0,-,0,0
심창민,61411,삼성,1,0,0,0,-,0,0
우동균,78454,삼성,8,0,0,0,-,0,0
이성규,66409,삼성,15,0,0,0,-,0,0
이영욱,78467,삼성,6,0,0,0,-,0,0
장필준,77927,삼성,3,0,0,0,-,0,0
최경철,73824,삼성,25,0,0,0,-,1,0
최원제,77466,삼성,11,0,0,0,-,0,0
최충연,66451,삼성,1,0,0,0,-,0,0
강장산,64907,KT,1,0,0,0,-,0,0
김만수,65044,KT,10,0,0,0,-,1,0
김사율,99563,KT,1,0,0,0,-,0,0
김연훈,77609,KT,19,0,0,0,-,0,0
김재윤,65062,KT,5,0,0,0,-,0,0
남태혁,66052,KT,31,0,0,0,-,0,0
류희운,64029,KT,1,0,0,0,-,0,0
배우열,79191,KT,1,0,0,0,-,0,0
배제성,65516,KT,1,0,0,0,-,0,0
심재민,64017,KT,1,0,0,0,-,0,0
엄상백,65056,KT,3,0,0,0,-,0,0
오정복,79453,KT,81,1,0,1,0.0,2,0
유한준,74339,KT,133,2,0,2,0.0,2,0
윤근영,75730,KT,1,0,0,0,-,0,0
윤석민,74215,KT,142,1,0,1,0.0,7,0
윤요섭,78892,KT,22,0,0,0,-,0,0
이상화,77563,KT,4,0,0,0,-,0,0
이재근,67092,KT,6,0,0,0,-,0,0
이진영,99810,KT,103,0,0,0,-,2,0
장성우,78548,KT,118,4,0,4,0.0,2,0
조무근,65067,KT,1,0,0,0,-,0,0
주권,65060,KT,2,0,0,0,-,0,0
홍성무,65042,KT,1,0,0,0,-,0,0
홍성용,75149,KT,2,0,0,0,-,0,0
